R 800 600
NO ./resources/tile1.xpm
SO ./resources/tile2.xpm
WE ./resources/tile3.xpm
EA ./resources/tile4.xpm

S ./resources/vase.xpm
F 104, 128, 136
C 168, 152, 104

111111     111111111
100001    10000000001
1000001  1000000000001
1000001111000000000001111111111111           111111
1000000110000000000001000000000001          10000001
1000000000000000000000000000000001         1000000001                    11111111111111111
1000000000000000000000000000000001        100000000001                   10000000000000001
1000000000000000000000000000000001        100000000001                   10000000000000001
111111000000000000000000000000000111111111100000S0000111111111111111111  10000000000000001
     100000000000000001000000000010000000010000000000000000000000000001   100000000000001
     100000000100000001000000000010000000010000000000000000000000000001    1000000000001
     100000000100000001111111111110000000010000000000000000000000000001    1000000000001
     111111100100000000000000000000000000011111111111111111111111000001    1000000000001
     12000000010000000000000000000000000001                     100000111111000000000001
     12000000010000000100000000000000000001                     100000000000000000000001
     11111111110000000100000000000000000001                     100000000000000000000001
              10000000111111111111111111111   111111111111111111100000000000000000000001
              100000001                       100000000000000000000000000000000000000001
              100000001                       100000000111111111111111111111111111111111
      11111111100000001    1111111            100000001
      10000000000000001   100000001           10000001
      10000000000000001  10000000001          1000001
      10000000000000001 1000000000001         100001
1111111000000000000000111000000000001         10001
10000000000000000000000000000000000011111111111001
10000000000000000000000000000000000000000000000001
10000000000000000000000000000000000000000000000001
11111111111111111111111111111111111111111111111111
