R 800 600
NO ./resources/tile1.xpm
SO ./resources/tile2.xpm
WE ./resources/tile3.xpm
EA ./resources/tile4.bmp

S ./resources/vase.xpm
F 104, 128, 136
C 168, 152, 104

1111111111111111111111111111111
1000000000000000000000000000001
1000000000000000000000000000001
1000000000000000000000000000001
1000000000000000000000000000001
1000000000111111111111111111111
10000000001
10000N00001
10000000001
10000000001
10000000001
1000000000111111111111111
10000N0000000000000000001
1000000000000000000000001
1000000000000000000000001
1000000000000000000000001
1000000000111111111111111
10000000001
10000000001
10000000001
10000000001
10000000001
10000000001
10000000001
10000000001
11111111111
